目标公司	湖南机械之家信息科技有限公司地址：长沙高新开发区谷园路38号加州阳光城西组团9栋1202房主营业务：信息技术咨询服务；工程机械管理服务；工程机械检测技术服务；机械设备租赁；建筑工程机械与设备租赁；计算机技术开发、技术服务；第二类增值电信业务中的呼叫中心业务、信息服务业务（仅限互联网信息服务）；网络技术的研发；数据处理和存储服务；广告设计；软件互联网销售；市场调研服务；贸易咨询服务；机械技术咨询、交流服务；机械技术转让服务；价格评估；电子交易平台的服务与管理；信息系统集成服务；拍卖；汽车零配件零售；机械配件、二手车的销售；广告发布服务、制作服务。（依法须经批准的项目，经相关部门批准后方可开展经营活动）目标公司及其子公司，目标公司或其子公司直接或者间接控制的任何实体，目标公司的控股公司，包括为本次投资之目的而新设立的与目标公司有关系的任何主体，以下合称为“集团公司”，单独称为“每一集团公司”。
创始人	刘旭龙，中国公民，身份证号码【430103198208123554】（“创始人1”）肖平，中国公民，身份证号码【430421198508147334】（“创始人2”）黄源亮，中国公民，身份证号码【430681198405225513】（“创始人3”）
投资人	合肥华颖兴智基金合伙企业（有限合伙）（“华颖基金”）
投资金额及股本结构	投资人投资金额为人民币612[贺伊韩1] 万元（“投资额”），认购目标公司的新增【261,600】元注册资本，投资后目标公司估值为【6800】万元人民币。投资后目标公司股本结构如下：注：华颖投资640万元，投资人2（跟投方）投资160万元，合计800万元，投后估值6800万。股东名称或姓名注册资本金额（人民币元）股权比例（%）刘旭龙1,701,08258.52%肖平149,4595.14%黄源亮149,4595.14%相泰启宏494,11617.00%麓谷高新47,0601.62%云游网络23,5300.81%华颖基金261,6009.00%其他80,3612.77%共计2,906,667100.00%
股东名称或姓名	注册资本金额（人民币元）股权比例
资金的用途	投资款及其收益应仅被用于目标公司的运营和主营业务的开发，不得用于偿还或解决目标公司对其股东、董事、雇员或与上述各方有任何关联的其他公司或人员的债务。对超出上述范围的使用，均需要经公司董事会的事先书面批准。
监事	本轮投资完成后，目标公司设置1名监事，由华颖基金委派。
陈述和保证	集团公司及创始人共同连带地做出标准的和惯常的陈述和保证，包括但不限于：1)组织和良好存续，股本结构清晰；2）股份有效发行；3）获得全部政府批准、资质和执照；4）目标公司不存在未向投资人披露的，针对创始人或目标公司的未决诉讼或仲裁以及未履行的裁判、裁决或行政调查、处罚；5）全部资产（包括知识产权）的完整所有权；6）与关键员工签订令投资人满意的劳动协议、保密协议和竞业限制协议；7）保证全部披露真实、准确和完整；8）税务记录和公司记录完整；9）财务报表真实准确；10）无关联交易；11）重大合同已披露；12）创始人所持有目标公司之股权为其合法持有、不存在任何瑕疵，并未设定任何抵押、质押、留置等担保或其它任何第三者权益；13）重大方面合规等。目标公司应促成其全部股东就本轮投资作出惯常的陈述与保证，包括但不限于：取得签署、交付并履行交易协议的同意和批准、放弃本轮新增注册资本的优先认购权等。
交割条件	拟议交易的交割条件至少应包括：1. 就任何集团公司而言，已从现有股东和相关各方取得所有必需的批准和同意，包括但不限于董事会批准；2. 投资人完成在法律、财务和业务方面的尽职调查，结果令投资人满意；3. 投资人同意自本协议签署之日起连续12个月的业务计划和预算； 4. 目标公司应当已经与关键员工（包括创始人）签署令投资人满意的劳动合同和/或保密协议、知识产权转让协议和不竞争协议；5. 有关各方签署并交付适当的最终协议（包括但不限于投资协议、股东协议、修订后的公司章程及其他交易性文件）；6.其他惯常交割条件。
创始人股权兑现时间	只要创始人作为服务提供者的持续状态没有终止，那么创始人的全部股权将自2016年8月16日交割日起分四年匀速兑现，每年兑现四分之一。如果创始人在此期间内主动终止其雇佣关系或者服务关系，或者因故意、重大过失导致公司重大损失经董事会同意后及其他正当理由被目标公司终止该等关系，则创始人应以法律允许的最低价格将其未成熟股权按公司其他股东之间各自相对的持股比例转让给公司其他股东。注：创始人股权兑现在上轮投资协议中已有约定，应按上轮约定的锁定时间。
创始人/关键员工不竞争承诺	在创始人/关键员工任职于任何目标公司及直接或者间接持有任何目标公司股权期间（以较晚者为准）以及该等期间结束后的24个月，创始人/关键员工不得直接或间接从事与公司主营业务相竞争的业务，不得在与目标公司有竞争关系的公司或者实体任职，或者劝诱目标公司的董事、高级管理人员、员工、客户或者合作伙伴离职。同时，创始人承诺将全部精力、工作时间投入目标公司的经营和管理。
优先分红权	未经投资人书面认可，目标公司不得进行任何利润分配。董事会制定的利润分配方案，并经股东会审议同意（包括投资人）派发股息、红利时，投资人有权优先获得本轮投资额范围内的【8%/年（单利）】的股息，剩余部分投资人与其他股东按照投资额比例分配股息。注：不同意8%的股息
清算优先权	在合格IPO（含新三板）之前，目标公司因任何原因导致任何法律法规规定的破产清算或者解散清算时，在公司的可分配财产或转让价款总额中，投资人有权优先于公司的其他股东取得相当于其投资额180150%（注 ：上轮为150%）的金额（简称“清算优先额”），加上已产生但未付的收益（包括但不限于股息与红利）。剩余的可分配财产或转让价款总额由全体股东（包括投资人）按各自的持股比例（不包括创始人所代为持有的员工期权）分配。除法定清算事由外，除非投资人以书面形式作出相反确认，以下事由应视同目标公司的清算事件（“视同清算事件”）：1)       公司的股东在交易后不再持有存续公司发行在外的多数股权的兼并、收购或者合并，或其他导致目标公司控制权发生变化的任何形式的交易；2)       转让目标公司全部或实质上全部资产、业务或对其进行任何其他形式的处置；3)       将目标公司的知识产权全部或实质上许可或转让给任何第三方。
赎回权	自交割日起【60】个月后，目标公司或创始人有严重违约投资协议的行为且未在30日内得到及时补救，投资人有权要求创始人或目标公司以下述价格的较高者（“赎回价格”）赎回全部或者任何本轮股权： 本轮投资额按照【15【8%】（不合理）的复合年回报率计算的金额加上已产生但未付的收益（包括但不限于股息与红利），或者投资人认可的独立第三方评估机构评估的投资人股权的公允市场价格。赎回价格和数量将根据拆股、股息派发、资本重组和其他类似情况进行相应调整。
防止稀释权	目标公司应确保后续融资前目标公司估值不得低于本次投资后目标公司估值。如经投资人书面同意，后续融资前公司的估值低于本次投资后估值，则投资人有权以零对价或法律允许的最低价格获得因估值降低而被稀释的股权（“差额股权”），使投资人购买股权价格摊薄至新投资人购买股权的价格；或者投资人认可的其他方式进行补偿。本轮投资交易完成前，目标公司【18【14.81】%的股权将用于对目标公司核心技术员工和管理人员的激励（“员工激励股权”），该员工激励股权由创始人1代为持有。创始人和目标公司确认并同意，投资人完成本轮投资后，投资人、创始人2、创始人3的持股比例不会因为上述员工激励股权的设立而被稀释。如果后期该员工激励股权的比例需要增加，投资人的持股比例将参与【18【14.81%】员工激励股权之外增加部分的稀释。（取消该条有关期权池的条款）
信息权	目标公司需要向投资人交付：1)       在每一财务年度结束后的90天内提供经审计的年度合并财务报表，2)       在每个季度结束后的30天内提供未经审计的季度合并财务报表，3)       在每月结束后的30天内提供未经审计的月度合并财务报表，以及（如适用）4)       在每个财务年度结束前的45天内提供年度合并预算。审计依据中国公认的会计准则（PRC GAAP）或国际财务报告准则（IFRS），并由投资人认可的合格的会计师事务所进行。只要投资人持有公司股权，投资人应享有通常的检查权（包括但不限于查看任何目标公司的全部财务账簿和记录的权利）。
优先认购权	未来目标公司新增注册资本时，全体股东有权按照其在公司的持股比例认购新增注册资本的权利。（向员工发行的期权和股份除外。）
优先受让权	目标公司的任何其他创始股东人拟转让其所持有的全部或部分公司股权时（因员工股权激励计划而转让股权除外），投资人享有按比例优先受让的权利。
领售权	若有第三方愿意以本轮投资后目标公司估值的50倍以上的金额收购目标公司（包括任何涉及出售公司全部或实质上全部股权或资产或业务的交易）时，若投资人书面同意该交易，则目标公司全体股东应同意该交易并在表决中投赞成票。
共售权	如果投资人之外的目标公司的其他创始股东人决定出售其持有的目标公司股权，投资人应享有按比例按照相同的条款和条件共同向受让方转让部分或者全部股权的权利，但因员工股权激励计划而转让股权除外。
合格IPO	目标公司和创始人承诺尽力在交割日起60个月后完成境内外合格资本市场（包括全国中小企业股份转让系统(新三板)）的上市，且上市前目标公司估值不低 【5亿元 】人民币。
保护性条款	在目标公司上市前，未经投资人事先书面批准，公司股东会不得，直接或者间接的采取下列任何行动：1)     对目标公司章程的任何修改；2)     增加或者减少目标公司注册资本；3)     目标公司的合并、分立、中止、解散；4)     变更目标公司的公司形式、经营范围；5)     目标公司进行任何形式的后续融资(无论股权融资或债权融资)，包括该等融资的任何条款或条件以及投资人的选定。6)     更换目标公司董事会的构成及人数；在目标公司上市前，未经投资人事先书面批准，公司董事会不得，直接或者间接的采取下列任何行动：1)     变更目标公司的主营业务，或从事任何与现有业务不同的新业务；2)     聘任或解聘目标公司的总经理、并决定其报酬；3)     制订、修改或终止目标公司的任何股权激励计划及该计划下的发股；4)     目标公司对外投资设立子公司、出售子公司或收购兼并其他企业；5)     目标公司任一会计年度内年度预算外发生的单笔或累计超过人民币【100】万元的银行或其他金融机构或非金融机构贷款；6)     目标公司任一会计年度内年度预算外发生的单笔或累计超过人民币【100】万元的资产购买、出售或其它方式的资产处置；7)     与目标公司股东、董事、高级管理人员或其关联方之间任一会计年度内单笔或累计金额为人民币【30】万元以上的关联交易；8)     制定目标公司的利润分配方案或亏损弥补方案；9)     为除目标公司以外的第三方提供担保或融资；10)   聘任或解聘对目标公司财务报表进行审计的会计师事务所；11)   改变目标公司的会计政策；12)   出售、转让、许可或以其他方式处置目标公司的专利、商标或其它知识产权；13)   在目标公司全部或部分业务、资产、权利上设定任何抵押、质押或其他权利负担；14)   出售、质押、转让、直接或者间接地处分或稀释公司在任何其他目标公司中的利益；15)   任何目标公司正常经营范围之外的其他活动。
投资人优惠条款	如果公司在未来完成的任何融资中，向其他投资人提供了比投资人更优惠的条件，则投资人有权取得该等优惠条件。
境外权益	若未来针对公司境内权益设立红筹架构并进行下一轮融资，投资人有权取得最终境外融资主体发售的与下一轮融资的投资人同一优先级别的优先股权，除拟议交易中所享有的优先权之外，投资人应当享有该等新投资人所享有的股票登记权等类似交易中惯常的权利。
新闻发布限制、保密及排他性	未经【华颖】事先书面同意，目标公司及创始人不得在任何场所向任何第三方披露本交易、与本交易有关的任何信息以及【华颖】为本交易而披露的任何信息。在本投资意向书签署【30】（20）天内，目标公司及全体股东不向投资人以外的任何第三方寻求洽谈，或接受任何对目标公司或创始人成立的其他实体进行股权、债权或者其他任何形式投资的要约，不参与任何有关上述投资的谈判，或就上述投资签署任何协议或做出任何承诺。
适用法律和争议解决	本意向书适用中华人民共和国相关法律，与本意向书有关的任何争议应当提交本意向书签订地合肥市高新区人民法院管辖。